NO ./pics/wall_north.xpm
SO ./pics/wall_south.xpm
EA ./pics/wall_east.xpm
WE ./pics/wall_west.xpm
C 76,137,166
F 48,44,52

111111
100101
101001
1100N1
111111
