NO ./pics/wall_north.xpm
SO ./pics/wall_south.xpm
EA ./pics/wall_east.xpm
WE ./pics/wall_west.xpm
C 76,137,166
F 48,44,52

111111111111111111111111
100000000000000000000001
100000000000000000000001
100000000000000000000001
100000111110000000000001
100000100010000000000001
100000100010000000000001
100000100010000000000001
100000111000000000000001
100000000000000000000001
100000000010000000000001
100000000010000000000001
100000000010000000000001
100000000010000000000001
100000000010000000000001
100000000010000000000001
100000000010000000000001
100000000010000000000001
100000000000000000000001
100000000000000000000001
10000000000000000N000001
100000000000000000000001
100000000000000000011001
111111111111111111111111
